
NO textures/moon/wall_moon_1.xpm
   SO         textures/moon/wall_moon_2.xpm
WE     textures/moon/    wall_moon_3.xpm

    EA     textures/moon/wall_moon_4.xpm

           F  34,67  ,135
C 34,65  ,253

11111
10001
10001
10001
10001
10001
11001
10001
10001
10001
1S001
10001
11111


