NO textures/sun/wall_sun_1.xpm
SO textures/sun/wall_sun_2.xpm
WE textures/sun/wall_sun_3.xpm
EA textures/sun/wall_sun_4.xpm

F 157,62,12
C 243,214,23

        1111111111111111111111111
        1000000000110000000000001
        1011000001110000000000001
        1001000000000000000000001
111111111011000001110000000000001
100000000011000001110111111111111
11110111111111011100000010001
11110111111111011101010010001
11000000110101011100000010001
10000W00000000001100000010001
10000000000000001101010010001 
1100000111010101111101100000111
11110111 1110101 101111010001
11111111 1111111 111111111111

         111111111111111
      111111111111111111111
     11111111111111111111111
   111111111111111110000000011
  11111111111111110000000000001
 1111111111111111000000000000001
111111111111111100000000000000001
111111111111111100000000000000001
111111111111111100000000000000001
111111111111111100000000000000001  
 1111111111111111000000000000001 
  11111111111111110000000000001  
   111111111111111110000000011  
    1111111111111111111111111
      111111111111111111111
         111111111111111
