111111111111111111111111111111
100000000000000C00000C00010001
110011110010000010100100010001
1P1100001010101000100100010001
101001001010101000100100010001
101001001010101000100100010001
101001001010101000100100010001
1010001010101010001001000100E1
100001000C00C00000000000000101
100001000C00C00000000000000101
100001000C00C00000000000000101
100001000C00C00000000000000101
100001000C00C00000000000000101
100001000C00C000000000000001C1
111111111111111111111111111111