1111111111111
10110C000C001
10C0011011111
1P00100E00C11
1111111111111