NO    textures/moon/wall_moon_1.xpm
   SO         textures/moon/wall_moon_2.xpm
WE     textures/moon/    wall_moon_3.xpm
    EA     textures/moon/wall_moon_4.xpm
           F  0,51,153
C 34,65  ,254

   111111
   100011
   110001
11100001
100N0111111
  111111111
1111111111
10000000001
11000111111
1000111111
10011 1001
1000011111
100001
111111