NO    textures/moon/wall_moon_1.xpm
   SO         textures/moon/wall_moon_2.xpm
WE     textures/moon/    wall_moon_3.xpm
    EA     textures/moon/wall_moon_4.xpm
           F  0,51,153
C 34,65  ,254

11S111
100011
110001
100001
100001
100001
110001
100011
100001
100001
100001
111111